****************************************
*     *   *      *         *           *
*     *   *      *         *    @      *
*     ** **      *         *           *
*                *         *           *
*                ******  ***           *
*  ****                                *
*  *  *                                *
*  *                                   *
*  *  *     *****  ****                *
*  ****     *         *                *
*           *         *                *
*           *         *                *
*           ***********       []  []   *
*                                      *
*                                      *
*                             []  []   *
*                                      *
*                                      *
****************************************

